#######-------------##########
######--------------######---#
##-----------------#####-----#
##-----------------####------#
##----######-------#---------#
##----######----####-----#---#
##----------------------####-#
#####-----###-----------######
#####-----###-----------######
##----------------------######
##--------------------------##
##--------------------------##
###########------------------#
##-------------########------#
##-------------########------#
##-------------########------#
##-------------########------#
##--#####---#----------------#
##----------#----------------#
##---------------------#######
##---------------------#######
#####------------------------#
##-------####----------------#
##---------------------------#
##---------------#########---#
##---#####-------#########---#
##---#####-------------------#
##---------------------------#
##------------------------##-#
##----####---------------#####
##-----------------------#####
##--------###------------#####
###-------###------------#-###
###-------###-----------##-###
##-------------------###-----#
##----#######--------#-------#
##----#######----------------#
##---------------------------#
##---------------------------#
##----------------------######
##---------------##-----######
##-----####----#####----######
##-------------#####---------#
#----------------------------#
#----------------------------#
#-----####-------------------#
#----------------------###---#
###------------------###-##--#
###-####-----------########--#
###-----------------#######--#
#---#######------------------#
#---#######------------------#
#---#######------------------#
#----------------------------#
#--------------------#########
#--------####------###########
#----------------------------#
#######-----------------######
#######------#----------######
##############---------------#
