#-------------------------####
#-------------------------####
###--------------#############
#------####------------#######
#------####------------#######
#----------------------------#
#---##------------############
#---##-----------------------#
#---##-------------###-------#
#---##-------------###-------#
#---##--#----------###-------#
#---##--#----------###-------#
#-------#----------###-------#
#----##-#----------###-------#
#----#####---------###-------#
#------###-------------------#
#------###-------------------#
#------###--#----------------#
#------###--#------####------#
#------###--#------####------#
#--###------#------####------#
#--###------#------####------#
#-----------#----------------#
#-----------#----------------#
#-----------#----------------#
#----#####--#----------------#
#----#####--###########------#
#-----------###########------#
#-----------#-------------####
#-------------------------####
#------------------#########-#
#######------------#########-#
#######----------------------#
#----------------------------#
#----------------------------#
#----------------------------#
#--------##-----##-----------#
#--####--##-----##-----------#
#--------####---##-----------#
#--------##-----##-----------#
#--------##-----##-----------#
#--------##-----##-----------#
#---#######-----##-----------#
#---#######-----##-######----#
#--------##-----##-----------#
#--------##-----##-----------#
#----######------------------#
#--------###--------######---#
#--------###-----------------#
#--------##------------------#
#---------------######-------#
#-----#####-----######-------#
#-----#####-----######-------#
###--------------------------#
###--------------------------#
###-------------------########
###-------------------########
#######----------------------#
#######----------------------#
#######----------#############
